101 101 0
#####################################################################################################
#S  #         #   #   #           #         #                     #     #       #       #         #G#
### # ##### # # # # # # ##### ### ### # # ### ############# ##### # # # # ### # ##### # ####### # # #
# # # #   # #   # # # #   # #   #   # # # #   #     #     #   # # # # # # #   #       #         # # #
# # # # # # ##### ### ### # ### ### ### ### ### # ### ### ### # # # # # ### ##################### # #
#   # # #   #       #   # #   # #     # #   # # #   # #   #   # # # # #     #               # #   # #
# ### # ########### # # # ### # ##### # # ### # ### # # ### ### # ### ####### ######### ### # # ### #
#   # # #       #   # #       #   #     # #   # # # # #     #         #     #     #   #   #   #     #
### ### # ##### # ### ########### # ##### # # # # # # # ############### # ####### ### ### ######### #
#   #   # #     # # # #     #   # # # #   # # #   # # # #           #   #         #     #         # #
# ### ### # ##### # # # ### # # # # # # ### # # ### # ### ######### # ############# ### ##### ### # #
# #       #     # #   #   #   #   # # # #   #   #   #     #     #   #     #       #   #     # # # # #
# # ########### # ####### ######### # # ####### # # ####### ##### ####### # ##### # # ### ### # # # #
# #           # #     #   #       #   #   #   # # # #       #     #     # #   # # # #   # #   #   # #
# ############# ##### # ### ##### ### ### # # ### # ### # ### ##### ### # ### # # ### # ### ### ### #
#         #   #   # # #     #   #   #   # # #     #     # #   #     #   #     # #   # # #   #     # #
######### # # ### # # # ##### # ### ### # # ### ##### ##### # # ##### ######### ### ### # ######### #
#       #   #     # # #       # # # #   #   #   #   # #     # # #   # #       #   #     #       #   #
# ##### ########### # ######### # # ######### ### # ### ##### # # # # ### ### ### ##### ####### # ###
#     # # #         #   #   #     # #       #   # #     #     # # # #   # #     #     #   #   # #   #
##### # # # ### ### ### # # # ##### # ##### ### # ### ##### ### # # ### # ##### ##### ### # # # ### #
#     #   #   #   #   # # #   #   #       #     # #   #   #   #   # #   #     # #     #   # # #     #
# ### ####### ### ### # ####### # ########### ### ##### # ####### ### ### ### # # ### # ### # #######
#   # #   #   # # #   # #   #   #   #       #   #   #   #         #   #   #   #   #   # #   #       #
### # # # # ### # ##### # # # ##### # ##### ####### # ############# ### ### ####### ### ####### ### #
#   # # #   #   #   #   # # #   # # #   # #       # # #   #     #   # # # # #     #   # #       # # #
# ##### ##### ##### # ### # # # # # ### # ####### # # # ### ### # ### # # # # ### ##### # ####### # #
#     #   #       # # #   # # # # #     #       # #     #   #     #   #   # #   #     #   # #     # #
# ### ### ##### # # # # # # ### # ############# # ####### ######### ##### # ### ##### ##### # # ### #
#   #   #     # # #   # # #     #         #     #   #     #     #         # #   #       #     #     #
####### ##### # # ####### ### ##### # ### # # ##### # # ### ### ######### # # ### ##### # ###########
#       #   # # #   #     #   #   # # # # # # #   # # # #   # #         # #   #   #   # #   #       #
# ##### # # # # ### # ######### # # # # # # # # # # # ### ### ######### # ##### ##### # ### ##### # #
#   #   # # # # #   #           # # # #     # # #   #     # #       #   # #   #   #   # # #       # #
# # ### ### # # ### ### ######### # # # ####### ##### ##### # # ##### ### # # ### # ### # ######### #
# #   #     # #   #   #       #   # # #   #     #       #     #     # #   # #   # #     #     #   # #
# ### ##### # # # ### ##### ### ### # ##### ########### ##### ##### # # ### ### # ##### # ### # # # #
#   #     # # # # #   #     #   #   #     #   #       #     # #   # # #   # #     #   # #   # # #   #
### ##### # # ### # ######### ### ####### ### # # ### ##### ### # # # ##### ####### # # # # ### #####
# #   #   # #   # #           #   #     #   # # # #   #   # #   #   # #   #         # # # #   #     #
# # ### ### ### # ############# ####### ### # ### ### # # # # ### ### # # # ######### # ##### ##### #
#   #   #   # # #   # #     #   #   #   #   #   #   # # # #   # # #   # # #   #       #         #   #
# ### ### ### # ### # # # ### ### # # ### # ### ### # # # ##### # # ### # ##### ############### # ###
#   # #   #   #     # # #         #   #   #   #   # # # #         #     #     # #   #     #     #   #
# ### # ### ######### # ############### ######### # # ######### ############# # # # # ### ### ##### #
# #   #   #           #   # #         #       #   # #         #             # #   #   # #   #     # #
### ##### ### ####### ### # # ####### ####### # ### ######### ############# # ### ##### ### ##### # #
#   #         #   #     # # # #               #   # #       #         #     #   #   #     # #   # # #
# ##### ####### # ##### # # # ############### ### # # ##### ######### # ####### ### # ##### # # # # #
#     #   #     #     # #   #       #       # # #   # #   #   #   #   #       #   #   #     # # # # #
# ### ##### ######### ##### ####### # # ### # # ##### # # ### ### # ### ######### ##### ##### ### # #
# # #       #       #             # # #   # #   #     # # #   #   #   # #         #     #         # #
# # ############# # ############# # ##### ##### ##### # # # ### ##### ### ######### ######### ##### #
# #     #   #     #   #   #   # # #     #     #       # # # #       # #   #       #         # #     #
# # # # # # # ####### # ### # # # ##### ### ########### # # ##### ### # ### ####### ####### # # #####
# # # #   #   #         #   # # #     #   #   #     #   # #     #   #   # #         #   #   # # #   #
# ### ### ############# # ### # ##### ### # # # # ### ### ##### ### ##### # ######### ### ##### # ###
#   #   # #         #   # #   # #   # # # # #   # #   #       # #         #   #         #       #   #
### ### # # ####### ##### # ### # # # # # ####### # ### ####### # ##### ##### ##### ### ######### # #
# #     # # #     #   #   #   #   #     #   #     # # #           #   # #   #     #   #         # # #
# ####### # # ### ### # ##### # ########### # ##### # ############# # ### # ##### ### ### ##### # # #
#         # #   # #   # #   # #   #   #     # #   #     #           #     #     #   # # #     # # # #
# ######### ### # # ### # # # ### # # # ##### # # ##### # ################# ### ### # # ##### # ### #
#         # #   # #     # # # #   # #   # #     #     # # #   #     #     #   # #   # #     # #   # #
### ####### # ### ######### # ##### ##### # ##### # ### # # # ##### # ### ### ### ### # ### # ### # #
# # #       #   # #         #       #     # # #   # #   #   # #     # #     #     #   # # # #   #   #
# # # ######### # ### ### ########### ##### # # ### # ####### # ##### # ########### ### # # ### ### #
# # #   #       #   #   #     #     #       # # #   # #     # # #     #   #     #       # # # # #   #
# # ### # ######### ### ### ### ### # ####### # # ### # ##### # # ####### # # ### ####### # # # #####
# # # # # # #   #   #     #       # # #       # #   # #     # # #       # # #     # #   #   # #     #
# # # # # # # # # ##### ########### # # ##### # ### # ##### # # # ##### # # ##### # # # # ### ##### #
# # # # # # # # # #   # #     #     # #   #   # #   #   #   # #   #   # #   #   #   # # #         # #
# # # # # # # # # # # # # ### # ### # ### # # # ####### # ### # ### # ####### # # ### # ########### #
# # # #   #   # #   # # #   # # #   #   # # # #       # #   # # #   #         # # #   # #   #   #   #
# # # ######### ##### # ### # # # ##### # # # ##### # # ### # ### ############# ### ### # # # # # ###
# #       #     #   # #   # #   #   #   # # # #   # # #   # #   # #   #   #     #   #     #   # #   #
# ####### # ### # # # ### # ####### # ### # # # ### # ### # ### # ### # # # ##### ############# ### #
# #     # # #   # # # #   #   #     # #   # #   #   #   #     #   #   # # # # #     #     #   #     #
# # # ### # ##### # # # ##### ####### # ### ##### ##### ##### ##### ### # # # # ### # ### # # ##### #
# # #   # #   #   # # # #   #         # #   #   #   #   #   # #     #   #   # # # #   #   # # #   # #
# # ### # ### # ### # # ### ############# ### # ### # ### # # ##### # ####### # # ##### ### ### # # #
# #   # # #   # #     #               #   #   #   # # #   # #   #   # #         #     # #   #   # # #
# ### # # # ### # ########### ####### # # # ##### # ### ### ### # # # ####### ### ### # ### # ### # #
#   # # # # #   #   #   #     #     #   # #   # # #     # #   #   # #       #   #   # #   #     # # #
# ### # # # # # ##### # ##### # ### ##### ### # # ##### # ### # ########### ### # # ##### ####### # #
#     # #   # # #     #     # #   #   #   # #   #     #   # # # #     #   # # # # #     #       # # #
# ##### ### # ### ######### ##### ### ### # ### ##### ### # # # # # # # ### # # # ##### ####### # # #
# # #     # # #   #       #     # # #   #     #     #   #   # # # # #   #   # # # #     #     # #   #
# # # ##### # # ### ### ##### ### # ### ##### ##### ### ### # # # # ##### ### # ### ### # ##### # ###
#   # #     #   #   #   #   #   # #   #   # # #     # # #   #   # #     #   #       #   # #     # # #
##### # ############# ### # ### # # ##### # # # ##### # # ####### ##### ### ######### ### # ##### # #
#     # #     #     # #   #   #   #   #   #   # #   # # # #           #   #     #     #   # #       #
# # ### ### # ### # # # ### # ##### # # ####### # # # # ### ############# ##### ##### ### # ### #####
# # #   #   # #   # #     # # #     # #     #   # #   #     #     #       #   #     #     #   # #   #
# # # ### ### # ### ####### # ##### # ##### # ### ############# ### ##### ### ##### ##### ### ### # #
# # #     # # #   #         #     # #   #   # #   #           #   # #       #   #   #   #   #     # #
# ######### # ### ############### # # ### ### # ### ### ##### # # # ####### # ### ### # ### ####### #
# #         #   #   #       #   # # #   #     #       #     # # # # #   #     #   #   # #     #     #
# # ##### ##### ### # # ##### # # ##### ################### # ### # # # ####### ##### # ####### ### #
#       #           # #       #                             #     #   #               #         #   #
#####################################################################################################
